AA	AA
AB	AX
AD	AE
ADOS	AERO
AGA	AIA
AG	AI
AGO	AIR
AH	AD
AHS	ADO
AID	ACE
ALA	ANA
AL	AN
ALAP	ANAL
ALL	ANN
ALLS	ANNO
ALT	ANY
AMA	AMA
AM	AM
ANA	ABA
AN	AB
ANATA	ABAYA
ANNA	ABBA
ANN	ABB
ANT	ABY
APP	ALL
ARD	APE
ARGAL	APIAN
ARK	APT
ARS	APO
AT	AY
AUA	AGA
AVA	AKA
CAG	JAI
CALL	JANN
CAM	JAM
CAN	JAB
CARD	JAPE
CAR	JAP
CAT	JAY
DA	EA
DAK	EAT
DAL	EAN
DIF	ECU
DIS	ECO
DISH	ECOD
DOD	ERE
DO	ER
DOL	ERN
DONGA	ERBIA
DOO	ERR
DOY	ERF
DUMA	EGMA
FLAG	UNAI
FLOSSY	UNROOF
FLUSH	UNGOD
FOH	URD
FON	URB
FOR	URP
FOUD	URGE
GID	ICE
GIT	ICY
GOD	IRE
GOV	IRK
GUARS	IGAPO
HA	DA
HAD	DAE
HAHA	DADA
HAH	DAD
HAHS	DADO
HAJ	DAH
HAKA	DATA
HALID	DANCE
HAMAL	DAMAN
HAM	DAM
HAN	DAB
HAP	DAL
HAT	DAY
HOARD	DRAPE
HOAR	DRAP
HOT	DRY
ISBA	COXA
ISH	COD
ISO	COR
JA	HA
JAK	HAT
JAM	HAM
JAPS	HALO
JAR	HAP
JAVA	HAKA
KAB	TAX
KAF	TAU
KAGU	TAIG
KAID	TACE
KAIK	TACT
KAIS	TACO
KAK	TAT
KAM	TAM
KANG	TABI
KAPA	TALA
KARA	TAPA
KAS	TAO
KA	TA
KAT	TAY
KAVA	TAKA
LAD	NAE
LAM	NAM
LA	NA
LAND	NABE
LARD	NAPE
LAR	NAP
LAT	NAY
MAA	MAA
MAD	MAE
MAHMAL	MADMAN
MAID	MACE
MAK	MAT
MALA	MANA
MAL	MAN
MALS	MANO
MALT	MANY
MA	MA
MAMA	MAMA
MAM	MAM
MAMMA	MAMMA
MAND	MABE
MAP	MAL
MAR	MAP
MAT	MAY
MATS	MAYO
MAUD	MAGE
MM	MM
NA	BA
NAH	BAD
NAM	BAM
NANA	BABA
NAP	BAL
NAT	BAY
NOAH	BRAD
NOGS	BRIO
NOO	BRR
NOS	BRO
NOSH	BROD
OAK	RAT
OAKS	RATO
OAR	RAP
OAT	RAY
ODAH	READ
ODAL	REAN
ODD	REE
OD	RE
ODS	REO
PAH	LAD
PAID	LACE
PA	LA
PAM	LAM
PANGA	LABIA
PAN	LAB
PAR	LAP
PAT	LAY
PSIS	LOCO
PST	LOY
RAH	PAD
RAIA	PACA
RAID	PACE
RAIK	PACT
RAI	PAC
RAIS	PACO
RAIT	PACY
RAJ	PAH
RAM	PAM
RAP	PAL
RAPT	PALY
RASPS	PAOLO
RAT	PAY
ROAM	PRAM
ROD	PRE
ROSY	PROF
ROT	PRY
SAV	OAK
SAY	OAF
SHA	ODA
SHH	ODD
SH	OD
SIKA	OCTA
SLID	ONCE
SOAP	ORAL
SOD	ORE
SOH	ORD
SOHS	ORDO
SON	ORB
SO	OR
SOUT	ORGY
SOY	ORF
SPRAD	OLPAE
ST	OY
SUDD	OGEE
TAD	YAE
TAJ	YAH
TAM	YAM
TANA	YABA
TANNA	YABBA
TAO	YAR
TAR	YAP
TAT	YAY
TAU	YAG
TAV	YAK
TA	YA
UDAL	GEAN
UDS	GEO
UFO	GUR
UG	GI
UGH	GID
UGS	GIO
US	GO
VAG	KAI
VAN	KAB
VARA	KAPA
VAT	KAY
VATS	KAYO
VAUS	KAGO
VAV	KAK
YAD	FAE
YA	FA
YAH	FAD
YAHS	FADO
YAK	FAT
YALD	FANE
YAPP	FALL
YAR	FAP
YGO	FIR
YOS	FRO
