AA	AA
ABA	ANA
AB	AN
ABAYA	ANATA
ABBA	ANNA
ABB	ANN
ABY	ANT
ACE	AID
AD	AH
ADO	AHS
AE	AD
AERO	ADOS
AGA	AUA
AIA	AGA
AI	AG
AIR	AGO
AKA	AVA
ALL	APP
AMA	AMA
AM	AM
ANA	ALA
AN	AL
ANAL	ALAP
ANN	ALL
ANNO	ALLS
ANY	ALT
APE	ARD
APIAN	ARGAL
APO	ARS
APT	ARK
AX	AB
AY	AT
BABA	NANA
BAD	NAH
BAL	NAP
BAM	NAM
BA	NA
BAY	NAT
BRAD	NOAH
BRIO	NOGS
BROD	NOSH
BRO	NOS
BRR	NOO
COD	ISH
COR	ISO
COXA	ISBA
DAB	HAN
DADA	HAHA
DAD	HAH
DADO	HAHS
DAE	HAD
DA	HA
DAH	HAJ
DAL	HAP
DAMAN	HAMAL
DAM	HAM
DANCE	HALID
DATA	HAKA
DAY	HAT
DRAPE	HOARD
DRAP	HOAR
DRY	HOT
EA	DA
EAN	DAL
EAT	DAK
ECOD	DISH
ECO	DIS
ECU	DIF
EGMA	DUMA
ERBIA	DONGA
ER	DO
ERE	DOD
ERF	DOY
ERN	DOL
ERR	DOO
FADO	YAHS
FAD	YAH
FAE	YAD
FALL	YAPP
FANE	YALD
FAP	YAR
FAT	YAK
FA	YA
FIR	YGO
FRO	YOS
GEAN	UDAL
GEO	UDS
GID	UGH
GIO	UGS
GI	UG
GO	US
GUR	UFO
HA	JA
HAKA	JAVA
HALO	JAPS
HAM	JAM
HAP	JAR
HAT	JAK
ICE	GID
ICY	GIT
IGAPO	GUARS
IRE	GOD
IRK	GOV
JAB	CAN
JAI	CAG
JAM	CAM
JANN	CALL
JAP	CAR
JAPE	CARD
JAY	CAT
KAB	VAN
KAGO	VAUS
KAI	VAG
KAK	VAV
KAPA	VARA
KAYO	VATS
KAY	VAT
LABIA	PANGA
LAB	PAN
LACE	PAID
LAD	PAH
LAM	PAM
LA	PA
LAP	PAR
LAY	PAT
LOCO	PSIS
LOY	PST
MAA	MAA
MABE	MAND
MACE	MAID
MADMAN	MAHMAL
MAE	MAD
MAGE	MAUD
MAL	MAP
MA	MA
MAMA	MAMA
MAM	MAM
MAMMA	MAMMA
MANA	MALA
MAN	MAL
MANO	MALS
MANY	MALT
MAP	MAR
MAT	MAK
MAY	MAT
MAYO	MATS
MM	MM
NABE	LAND
NAE	LAD
NA	LA
NAM	LAM
NAPE	LARD
NAP	LAR
NAY	LAT
OAF	SAY
OAK	SAV
OCTA	SIKA
ODA	SHA
ODD	SHH
OD	SH
OGEE	SUDD
OLPAE	SPRAD
ONCE	SLID
ORAL	SOAP
ORB	SON
ORDO	SOHS
ORD	SOH
ORE	SOD
ORF	SOY
ORGY	SOUT
OR	SO
OY	ST
PACA	RAIA
PACE	RAID
PACO	RAIS
PAC	RAI
PACT	RAIK
PACY	RAIT
PAD	RAH
PAH	RAJ
PAL	RAP
PALY	RAPT
PAM	RAM
PAOLO	RASPS
PAY	RAT
PRAM	ROAM
PRE	ROD
PROF	ROSY
PRY	ROT
RAP	OAR
RAT	OAK
RATO	OAKS
RAY	OAT
READ	ODAH
REAN	ODAL
REE	ODD
RE	OD
REO	ODS
TABI	KANG
TACE	KAID
TACO	KAIS
TACT	KAIK
TAIG	KAGU
TA	KA
TAKA	KAVA
TALA	KAPA
TAM	KAM
TAO	KAS
TAPA	KARA
TAT	KAK
TAU	KAF
TAX	KAB
TAY	KAT
UNAI	FLAG
UNGOD	FLUSH
UNROOF	FLOSSY
URB	FON
URD	FOH
URGE	FOUD
URP	FOR
YABA	TANA
YABBA	TANNA
YAE	TAD
YAG	TAU
YAH	TAJ
YAK	TAV
YAM	TAM
YAP	TAR
YAR	TAO
YA	TA
YAY	TAT
