	
ARD	APE
RAIT	PACY
MAMMA	MAMMA
PA	LA
TAU	YAG
JAR	HAP
MAID	MACE
SOY	ORF
UFO	GUR
RAIK	PACT
KA	TA
PAH	LAD
DISH	ECOD
ODS	REO
PAM	LAM
MAND	MABE
DOO	ERR
SOD	ORE
KAGU	TAIG
KANG	TABI
JAK	HAT
CAM	JAM
DONGA	ERBIA
KAB	TAX
SOUT	ORGY
YGO	FIR
KAF	TAU
MALS	MANO
DOL	ERN
TAO	YAR
RAM	PAM
GOD	IRE
JA	HA
KAS	TAO
NOSH	BROD
SOH	ORD
ARK	APT
FON	URB
YAPP	FALL
YAHS	FADO
VAT	KAY
KAM	TAM
NOS	BRO
RAPT	PALY
CARD	JAPE
DOY	ERF
NA	BA
SUDD	OGEE
UDS	GEO
PANGA	LABIA
TA	YA
CAN	JAB
LAT	NAY
NAT	BAY
NAP	BAL
ARGAL	APIAN
LAR	NAP
DA	EA
SAV	OAK
YA	FA
CALL	JANN
AD	AE
ROSY	PROF
ANNA	ABBA
UG	GI
SIKA	OCTA
YAR	FAP
ALA	ANA
HAM	DAM
LAND	NABE
SLID	ONCE
ISH	COD
KAT	TAY
RAT	PAY
ST	OY
RAI	PAC
UGH	GID
ADOS	AERO
RAH	PAD
HAHA	DADA
MAHMAL	MADMAN
PAT	LAY
HAH	DAD
ANN	ABB
HAHS	DADO
YOS	FRO
AB	AX
OAK	RAT
OAKS	RATO
LARD	NAPE
PAR	LAP
VAN	KAB
JAPS	HALO
FLUSH	UNGOD
HALID	DANCE
LAD	NAE
AID	ACE
HOT	DRY
NOO	BRR
ANA	ABA
FLAG	UNAI
VAG	KAI
AHS	ADO
KAVA	TAKA
ISO	COR
ROAM	PRAM
DAL	EAN
SO	OR
ANATA	ABAYA
DIF	ECU
DOD	ERE
OAT	RAY
TAD	YAE
MAM	MAM
AG	AI
SHA	ODA
DUMA	EGMA
DAK	EAT
ODAL	REAN
TAR	YAP
NAH	BAD
MAP	MAL
LA	NA
MAD	MAE
ROT	PRY
DIS	ECO
YAD	FAE
LAM	NAM
ODD	REE
RAID	PACE
MA	MA
MATS	MAYO
KAK	TAT
RASPS	PAOLO
AT	AY
OAR	RAP
HOAR	DRAP
HAD	DAE
HAT	DAY
DO	ER
YALD	FANE
CAG	JAI
MAK	MAT
AH	AD
MAA	MAA
YAH	FAD
TANNA	YABBA
SH	OD
NOAH	BRAD
ANT	ABY
VAV	KAK
VARA	KAPA
TAV	YAK
HAN	DAB
US	GO
ARS	APO
ALT	ANY
HAP	DAL
TAJ	YAH
GIT	ICY
SOHS	ORDO
SON	ORB
MAL	MAN
AMA	AMA
HA	DA
ALLS	ANNO
HOARD	DRAPE
PAN	LAB
KARA	TAPA
AL	AN
FOH	URD
GID	ICE
AGA	AIA
MALT	MANY
HAMAL	DAMAN
CAR	JAP
GUARS	IGAPO
RAIA	PACA
TAM	YAM
UGS	GIO
SPRAD	OLPAE
NAM	BAM
FOR	URP
AVA	AKA
FLOSSY	UNROOF
VAUS	KAGO
ROD	PRE
ODAH	READ
SHH	ODD
SOAP	ORAL
HAJ	DAH
VATS	KAYO
PSIS	LOCO
AN	AB
NOGS	BRIO
TAT	YAY
APP	ALL
MM	MM
AA	AA
ALAP	ANAL
KAID	TACE
NANA	BABA
ISBA	COXA
RAP	PAL
JAVA	HAKA
PST	LOY
OD	RE
AGO	AIR
GOV	IRK
MALA	MANA
KAIS	TACO
KAIK	TACT
MAT	MAY
MAUD	MAGE
TANA	YABA
ALL	ANN
FOUD	URGE
JAM	HAM
HAKA	DATA
AUA	AGA
RAIS	PACO
AM	AM
YAK	FAT
MAR	MAP
KAPA	TALA
RAJ	PAH
PAID	LACE
UDAL	GEAN
CAT	JAY
MAMA	MAMA
SAY	OAF
